---------------
--a----a-----a-
---------------
---aa---aa-a---
aaa--a----a--aa
---------------
---------------
--a----a---a---
-a--a----a----a
--------a------
-----a-------a-
---a----a------
-----------a---
-a---a----a----
---------------