{
  "name": "Enemy at the gates",
  "music": "arpent",
  "background": "galaxy",
  "nextlevel": "",
  "prestory": [
    {"image": "level1_pre1", "time": 7},
    {"image": "level1_pre2", "time": 7},
    {"image": "level1_pre3", "time": 4}
  ],
  "poststory": [
    {"image": "level1_post1", "time": 3},
    {"image": "level1_post2", "time": 5}
  ],
  "layout": ["---------------",
             "--a----a-----a-",
             "---------------",
             "---aa---aa-a---",
             "aaa--a----a--aa",
             "-----a-------a-",
             "---a----a------",
             "-----------a---",
             "-a---a----a----",
             "---------------",
             "---------------",
             "---------------",
             "---------------",
             "------s--------",
             "-a------------a",
             "a--a-a---a--a--",
             "aa--a---a-a--a-",
             "-a-a---a-a--a--",
             "a-a---a---aa--a",
             "-a---a-a-a---a-",
             "a---a-aa---a---",
             "-a---a--a-a--aa",
             "-aa---a-----a--",
             "a--a---a-aa--a-",
             "a-a-a---a--a---",
             "-a-a-a---a---a-",
             "-a-a--a---a-a--",
             "-a--a--a---a-a-",
             "aaaaaaa----aaaa",
             "_______________",
             "-------1-------",
             "---------------",
             "-------s-------",
             "---------------",
             "-----s---s-----",
             "---------------",
             "---s---s---s---",
             "---------------",
             "---------------",
             "--a----a---a---",
             "-a--a----a----a",
             "--------a------"
  ]
}
